aatrox: esta batalla sera mi obra maestra
ahri: hoy nos sentimos traviesos eh
akali: como lo dicta el equilibrio
alistar: no hay nada que me detenga
amumu: pense que nunca me escogerias
anivia: sobre mis alas
annie: tu tambien quieres jugar, sera divertido
ashe: todo el mundo en una flecha
azir: shurima, tu emperador ha vuelto
blitzcrank: encendido y listo para el servicio
braum: y si quemamos el mundo
caitlyn: este caso es para mi
cassiopeia: no existe antidoto contra mi
cho'gat: quisieras ver el fin del mundo que conoces, si
corki: listo para destruir con mi maquina brutal
darius: solo yo lograre que lleguemos a la victoria
diana: una nueva luna se asoma
draven: bienvenidos a league of draven
mundo: mundo
ekko: no importa  cuanto tiempo tengas, si no como lo usas
elise: solo la ara√±a esta a salvo en su tela
evelynn: la noche vela mis actos
ezreal: es hora de dar una buena leccion
fiddlestick: como ordenes maestro
fiora: quiero encontrar un digno oponente
fizz: dejamelos a mi
galio: un guardian siempre esta preparado
gangplank: ni las llamas, ni las profundidas pudieron reclamarme
garen: mi corazon y mi espada, siempre, por demacia
gnar: gnar gada
gragas: si me pagas otra ronda me apunto
graves: condenado a muerte
hecarim: contemplen el poder de las islas de las sombras
heimerdinger: una sabia decision
